NO ./textures/eagle.xpm
SO ./textures/colorstone.xpm
WE ./textures/greystone.xpm
EA ./textures/bluestone.xpm
C 77,77,155
F 63,121,22

1111111111111111111111111111111111111111111111111111111111
1000000000000000000000000000000000000000000000000000000001
1000000000000N00000000000000000000000000000000000000000001
1000000000000000000000000000000000000000000000000000000001
1000000000000000000000000000000000000000000000000000000001
1000000000000000000000000000000000000000000000000000000001
1000000000000000000000000000000000000000000000000000000001
1000000000000000000000000001000000000000000000000000000001
1000000000000000000000000000000000000000000000000000000001
1000000000000000000000000000000000000000000000000000000001
1000000000000000000000000000000000000000000000000000000001
1000000000000000000000000000000000000000000000000000000001
1000000000000000000000000000000000000000000000000000000001
1000000000000000000000000000000000000000000000000000000001
1000000000000000000000000000000000000000000000000000000001
1111111111111111111111111111111111111111111111111111111111